# Grand Whimsy Forest level template v2
# One character is one 8x8 world-unit chunk. Coordinates are zero-based col,row.
# The 30x30 map therefore describes the complete 240x240 destination.
# F forest | P walkable path | C animal clearing | L lake (collision)
# G enchanted glen | R rock garden. Spawn is on the south path at col 14,row 27.
name: Grand Whimsy Forest
size: 240x240
cell: 8
seed: 73421
spawn: 14,24
legend: F=forest P=path C=clearing L=lake G=glen R=rock-garden
map:
FFFFFFFFFFFFFFPFFFFFFFFFFFFFFF
FFFFFFFFFFFFFFPFFFFFFFFFFFFFFF
FFFFFFFFFFFFFFPFFFFFFFFFFFFFFF
FFFFFFFFFFFFFFPFFFFFFFFFFFFFFF
FFFFFFFFFFFFFFPFFFFFFFFFFFFFFF
FFFFFLLLLFFFFFPFFFFFFFFFFFFFFF
FFFFFLLLLFFFFFPFFFFFFFFFFFFFFF
FFFFFLLLLFFFFFPFFFFFFFFFFFFFFF
FFFFFLLLLFFFFCCCFFFFFFFFFFFFFF
FFFFFFFFFFFFFFPFFFFFFFFFFFFFFF
FFFFFFFFFFFFFFPFFFFFFFFFFFFFFF
FFFFFFGGFFFFFFPFFFFFFFRRFFFFFF
FFFFFFFFFFFFFFPFFFFFFFFFFFFFFF
FFFFFFFFFFFFFFPFFFFFFFFFFFFFFF
FFPPPPPPPPPPPPPPPPPPPPPPPPPPFF
FFFFFFFFFFFFFFPFFFFFFFFFFFFFFF
FFFFFFFFFFFFFFPFFFFFFFFFFFFFFF
FFFFFFFFFFFFFFPFFFFFFFFFFFFFFF
FFFFFFFFFFFFFFPFFFFFFFFFFFFFFF
FFFFFFFFFFFFFFPFFFFFFLLLLFFFFF
FFFFFFFFFFFFFCCCFFFFFLLLLFFFFF
FFFFFFFFFFFFFFPFFFFFFLLLLFFFFF
FFFFFFFFFFFFFFPFFFFFFLLLLFFFFF
FFFFFFFFFFFFFFPFFFFFFFFFFFFFFF
FFFFFCCFFFFFFFPFFFFFFFFGGFFFFF
FFFFFFFFFFFFFFPFFFFFFFFFFFFFFF
FFFFFFFFFFFFFFPFFFFFFFFFFFFFFF
FFFFFFFFFFFFFFPFFFFFFFFFFFFFFF
FFFFFFFFFFFFFFPFFFFFFFFFFFFFFF
FFFFFFFFFFFFFFPFFFFFFFFFFFFFFF
